111111111111111111111111111111111111
100000000000000E00000000000000000001
100000000000000000000000000000000001
100111011101110111101000100101111001
10010C001P00100100101000100101001001
100111001000100111101000111101111001
100100001000100100101000100101001001
100111001000100100101110100101001001
100000000000000000000000000000000001
100000000000000000000000000000000001
111111111111111111111111111111111111
