111111111111111
1C0100C0000C001
101001111100001
1P001100C011001
100E00000C00001
10010111000C111
10010000000C011
100100011000011
100110C0011C011
1001C000C11C011
111111111111111
